recuperación	recovery, recuperation	nf
localizar	to locate, find, localize	v
mediano	average, medium, ordinary	adj
almuerzo	lunch	nm
pacífico	peaceful	adj
uña	nail, fingernail, toenail	nf
contradictorio	contradictory	adj
excepto	except for	prep
herir	to wound, hurt	v
costo	price, cost, expense	nm
manifiesto	to show	nm
mortal	mortal, lethal, deadly (adj)	adj
repetición	repetition	nf
patrimonio	patrimony, inheritance	nm
solemne	solemn	adj
estatua	statue	nf
decadencia	decline, decay	nf
mudo	mute, silent	adj
precipitar	to plunge, hurl, rush	v
sorprendido	surprised	adj
excluir	to exclude, reject	v
enfermero	nurse	nm/f
psicológico	psychological	adj
adorar	to worship, adore	v
aficionado	fan, devotee	nm
preferible	preferable	adj
célebre	famous, renowned	adj
agujero	hole, opening	nm
beneficiar	to benefit	v
arroz	rice	nm
valiente	brave, courageous, bold	adj
delicioso	delicious, delightful, charming	adj
potente	potent, powerful	adj
cerveza	beer, ale	nf
escasez	scarcity, shortage	nf
ministerio	ministry	nm
vuestro	your (plural familiar)	adj
notorio	notorious, noticeable	adj
transición	transition	nf
sexto	sixth	adj
despreciar	to despise, scorn	v
negativa	negative, denial	nf
falda	skirt	nf
improvisar	to improvise	v
emerger	to emerge, surface	v
clavar	to nail	v
cantante	singer	nc
constancia	perseverance	nf
electrónico	electronic	adj
anillo	ring	nm
balance	outcome, balance	nm
entendimiento	understanding	nm
volcar	to turn/knock over, empty	v
quieto	still, motionless, calm	adj
transcurso	passing, course, lapse	nm
barrer	sweep, clean out	v
desayuno	breakfast	nm
alfombra	rug, carpet mat	nf
historiador	historian	nm/f
rogar	to implore, pray, ask	v
pálido	pale, ghastly, faded	adj
programar	to plan, program	v
animado	excited, lively	adj
chileno	Chilean	adj
ficción	fiction	nf
ensayar	to test,&nbsp;rehearse	v
materno	maternal	adj
jugador	player, gambler	nm
cartel	poster	nm
desconfianza	distrust	nf
respiración	respiration, breath	nf
votar	to vote	v
caña	cane, reed	nf
aislar	to isolate, insulate	v
soltero	single, not married	adj
prisionero	prisoner	nm
turista	tourist (nc)	nc
abundancia	abundance	nf
rodar	to roll, run, scatter	v
asistente	assistant	nc
vinculado	connected	adj
queso	cheese	nm
arriesgar	to risk, venture	v
indicio	indication, sign	nm
colgado	hanging	adj
bautizar	to baptize, christen	v
cerro	hill	nm
desatar	to untie, unleash, spark off	v
alentar	to encourage	v
descargar	to unleash, unload	v
galería	gallery, balcony	nf
engaño	deceit, falsehood, hoax	nm
enamorar	to fall in love	v
geográfico	geographical	adj
continuidad	continuity	nf
receta	recipe, prescription	nf
conveniencia	convenience, usefulness	nf
reemplazar	to replace	v
carencia	lack, shortage [also falta]	nf
cerdo	pig, sow, slob	nm
