soplar	to blow (wind)	v
frágil	fragile, weak	adj
empeño	insistence, determination	nm
agresión	aggression, attack	nf
fortaleza	fortress, strength	nf
seriamente	seriously	adv
balcón	balcony	nm
observador	observer	nm
ridículo	ridiculous, absurd (adj)	adj
renta	income, rent	nf
justificación	justification	nf
enfrentamiento	confrontation	nm
junta	meeting, conference, seam	nf
irregular	irregular	adj
trayectoria	trajectory, path	nf
genial	brilliant, inspired	adj
indiferencia	indifference	nf
taza	cup, bowl	nf
vínculo	tie, bond, link	nm
cuaderno	notebook, workbook	nm
gracioso	funny, charming, amusing	adj
regir	to rule, govern, manage	v
intermedio	interim, intermediate (adj)	adj
bañar	to bathe, take a bath	v
temporal	temporary	adj
rozar	to touch lightly	v
pánico	panic	nm
distinguido	distinguished	adj
cañón	canyon, cannon	nm
dudoso	doubtful, dubious	adj
pollo	chicken	nm
lamentable	regrettable	adj
trascendencia	transcendent nature, significance	nf
remitir	to remit	v
interminable	endless, interminable	adj
corrupción	corruption	nf
confesión	confession, admission	nf
corbata	tie, sash	nf
macho	male, manliness	nm
disolver	to dissolve	v
secuencia	sequence	nf
cáncer	cancer	nm
velar	to watch over	v
archivo	archive, file, filing cabinet	nm
habitualmente	habitually	adv
trámite	procedure, step, requirement	nm
tranquilamente	calmly, peacefully	adv
innecesario	unnecessary	adj
raya	line, ray, stripe	nf
televisor	television set	nm
estabilidad	stability	nf
grandeza	greatness, size	nf
prisa	hurry	nf
persistir	to persist	v
temblar	to tremble, shake	v
verbal	verbal, oral	adj
matemática	mathematics	nf
demonio	demon, devil	nm
intacto	intact	adj
procedente	coming from [also proveniente]	adj
cenar	to dine	v
disponible	available	adj
tornar	to transform, turn	v
encantado	pleased, delighted	adj
británico	British	adj
manga	sleeve	nf
perjudicar	to endanger	v
laboral	labor, industry (adj)	adj
rubio	blonde, fair	adj
prevenir	to avoid, prevent [also evitar]	v
seda	silk	nf
envidia	envy	nf
emergencia	emergency	nf
enamorado	in love	adj
grasa	grease, fat	nf
culminar	to culminate, accomplish	v
alcalde	mayor	nm
insuficiente	insufficient	adj
sostenido	sustained, steady	adj
congreso	congress	nm
espantoso	frightening, dreadful	adj
aplauso	applause, praise, acclaim	nm
prima	female cousin, down payment	nf
ansiedad	anxiety	nf
dirigente	leader, director, manager	nc
ascenso	promotion, climb	nm
finalidad	purpose, aim	nf
preceder	to precede	v
financiero	financial	adj
nostalgia	nostalgia, homesickness	nf
mención	mention	nf
afición	fondness, interest	nf
colonial	colonial	adj
lástima	shame, pity	nf
teatral	theatrical	adj
lápiz	pencil	nm
vertical	vertical, upright	adj
nido	nest	nm
gratuito	free, arbitrary, gratuitous	adj
difícilmente	with difficulty	adv
