insoportable	unbearable, intolerable	adj
taxi	taxi, cab	nm
porción	part, portion, share	nf
timbre	doorbell, bell, seal, stamp	nm
monstruo	monster, monstrosity	nm
bebé	baby	nm
trayecto	trajectory, course, path	nm
globo	balloon, globe	nm
celebración	celebration	nf
quehacer	task, job, chore	nm
electoral	electoral	adj
obsesión	mania, obsession	nf
bronce	bronze	nm
formidable	formidable, tremendous	adj
licencia	license, permission	nf
motivación	motivation	nf
noventa	ninety	num
anoche	last night	adv
depresión	depression, slump	nf
pulmón	lung	nm
apoderar	to take power	v
debatir	to debate, discuss	v
reponer	to replace, restore	v
fibra	fiber, grain	nf
disputar	to dispute, contest	v
quinientos	five hundred	num
petróleo	oil, petroleum	nm
sucesivamente	successively, step by step	adv
permanencia	permanence, tenure	nf
vos	you (subj singular familiar) [also tú]	pron
miércoles	Wednesday	nm
horno	oven, furnace	nm
logro	success, achievement	nm
vientre	womb, belly	nm
petición	request, petition	nf
civil	civilian (nc)	nc
reparto	distribution, delivery	nm
advertencia	warning, notice	nf
arrebatar	to snatch, grab	v
previsión	forecast, precaution	nf
miserable	wretched, miserable	adj
grato	agreeable, pleasant	adj
mandato	mandate, order, command	nm
odiar	to hate	v
clave	key (adj)	nf
diecisiete	seventeen	num
timidez	shyness, timidity	nf
toque	touch, ringing, warning	nm
máscara	mask	nf
venganza	revenge, vengeance	nf
barba	beard	nf
alarma	alarm	nf
insinuar	to insinuate, hint	v
aliento	breath, courage, spirit	nm
pureza	purity, chastity	nf
fallecer	to pass away (to die)	v
comedia	comedy, play, pretense	nf
aldea	small village	nf
enérgico	energetic, vigorous	adj
eludir	to evade, avoid, elude	v
párrafo	paragraph	nm
permanentemente	permanently	adv
brillo	shine, twinkling, sparkle	nm
ocasionar	to occasion, bring about	v
rastro	track, sign, flea market	nm
concretamente	specifically, exactly	adv
ignorante	ignorant	adj
adorno	decoration, adornment	nm
curiosamente	strangely, funnily enough	adv
lógicamente	logically	adv
mono	monkey	nm
razonamiento	reasoning	nm
ilustrado	learned, illustrated	adj
pastor	shepherd, pastor	nm/f
tramo	section, stretch, plot	nm
reto	challenge, defiance	nm
altísimo	very high, tall	adj
estupendo	marvelous, stupendous	adj
pesadilla	nightmare	nf
centenar	hundred (nm)	nm
molestia	bother, nuisance, trouble	nf
restante	remaining	adj
paja	straw, thatching	nf
regional	regional	adj
cómico	comic	adj
concesión	awarding, concession	nf
tardío	late, belated	adj
nudo	knot	nm
retomar	to retake, restart	v
martes	Tuesday	nm
utilización	use, utilization	nf
tapa	cover, lid	nf
traición	treason, betrayal	nf
asentar	to settle, establish, locate	v
pesca	fishing	nf
malestar	discomfort, unease, unrest	nm
rata	rat	nf
puntual	punctual	adj
defensor	defender	nm
auxilio	help, aid, assistance	nm
