antemano	beforehand, in advance	adv
parir	to give birth	v
refugiar	to take shelter, give refuge	v
sillón	armchair, seat	nm
denso	heavy, dense, thick	adj
colectivo	collective, group (nm)	nm
dieta	diet	nf
teniente	lieutenant, deputy mayor	nm
polo	pole, polo, polo shirt	nm
verificar	to verify	v
agrícola	agricultural, farming	adj
abismo	abyss, large gap	nm
algodón	cotton	nm
harina	flour	nf
exactitud	accuracy	nf
extinguir	to extinguish, put out	v
provecho	benefit, use	nm
mensual	monthly	adj
agradar	to please	v
sobrepasar	excel, out perform	v
prudencia	prudence, moderation	nf
insulto	insult	nm
narrar	to narrate, tell	v
flujo	flow, tide, discharge	nm
aguja	needle, spire, stylus	nf
planteamiento	proposal, exposition	nm
simultáneamente	simultaneously	adv
florecer	to flower, bloom, flourish	v
torpe	clumsy, awkward, slow	adj
cortina	curtain, screen	nf
acarrear	to carry, result in, entail	v
liso	smooth, flat, straight	adj
asustado	scared, frightened	adj
profundizar	to deepen, analyze in depth	v
apostar	to wager, bet	v
propicio	appropriate, suitable	adj
reproducción	reproduction	nf
expansión	expansion, spreading	nf
umbral	threshold, outset	nm
alusión	allusion, hint	nf
descenso	decline, descent, lowering	nm
clasificar	to classify, sort, file	v
recortar	to trim, cut off, clip	v
dicho	aforementioned, said (adj)	nm
ambiguo	ambiguous	adj
océano	ocean	nm
proposición	proposition	nf
absurdo	absurdity, nonsense	nm
parada	transportation stop	nf
encantador	charming	adj
deslizar	to slide, glide, slip	v
estirar	to stretch, strain	v
respetuoso	respectful	adj
africano	African	adj
titular	headline, holder (nm)	nm
calendario	calendar	nm
interlocutor	participant in a dialog	nm
abusar	to abuse	v
complementar	to complement, supplement	v
disgusto	disgust, annoyance	nm
conservación	conservation	nf
revivir	to revive	v
elaboración	production [also producción]	nf
conmover	to move, affect	v
correo	mail, post office	nm
circo	circus	nm
adversario	adversary	nm
cubierta	covering, top, lid	nf
aniversario	anniversary	nm
franja	strip, stripe, fringe	nf
charlar	to chat, talk	v
pila	battery, pile, sink	nf
flaco	thin, frail	adj
biológico	biological	adj
equivaler	to be equivalent, tantamount to	v
fomentar	to foster, promote, encourage	v
goma	rubber	nf
enormemente	enormously	adv
ancho	width (nm)	nm
emocional	emotional	adj
diplomático	diplomatic (adj)	adj
uva	grape	nf
ética	ethics	nf
inscripción	inscription, registration	nf
progresivo	progressive	adj
reanudar	to renew, resume	v
adquisición	acquisition	nf
mudar	to move, change	v
glorioso	glorious	adj
sentir	feeling (nm)	v
turco	Turkish	adj
prescindir	to do without	v
renuncia	resignation, renunciation	nf
préstamo	loan, borrowing	nm
poblado	populated	adj
besar	to kiss	v
impreso	printed	adj
dedicación	dedication, devotion	nf
instituto	institute	nm
paloma	dove	nf
