servidumbre	staff of servants, servitude	nf
resucitar	to resuscitate, revive	v
psicólogo	psychologist	nm/f
sabroso	delicious, tasty	adj
actriz	actress	nf
esencialmente	essentially	adv
larguísimo	very long	adj
simultáneo	simultaneous	adj
burro	donkey	nm
procedencia	origin, source	nf
fiscal	district attorney, prosecutor (nc)	nc
trascendental	momentous, transcendental	adj
colorado	red, colored	adj
financiar	to finance	v
participante	participant	nm
rescate	rescue, ransom	nm
apuro	trouble, predicament	nm
sudar	to sweat	v
prestigioso	prestigious	adj
cautela	caution	nf
crónico	chronic	adj
táctica	tactics, strategy	nf
descuido	neglect, oversight	nm
bíblico	biblical	adj
matanza	slaughter, carnage	nf
perturbar	to perturb, upset	v
paterno	paternal	adj
escrito	manuscript, writing	nm
pinta	pint, aspect, dot	nf
envidiar	to envy	v
reposar	to rest, lie down	v
acelerado	accelerated, quick	adj
árido	arid, dry	adj
caprichoso	capricious, whimsical	adj
minúsculo	minute, insignificant	adj
caldo	broth, bouillon, soup	nm
agonía	agony, grief	nf
deteriorar	to deteriorate	v
tregua	truce, rest	nf
vestuario	wardrobe, changing room	nm
desesperar	to despair, lose hope	v
bodega	cellar, pantry, warehouse	nf
antena	antenna	nf
ligar	to tie, link, bind	v
maldad	evil, wickedness	nf
obediencia	obedience	nf
ocurrencia	idea, witty remark	nf
abiertamente	openly	adv
complemento	complement, supplement	nm
editor	editor, publisher	nm/f
periodismo	journalism	nm
piscina	swimming pool	nf
provincial	provincial	adj
mediar	to mediate	v
endurecer	harden, make hard	v
tradicionalmente	traditionally	adv
inyección	shot, injection	nf
ilegal	illegal	adj
reproche	reproach, criticism	nm
consistencia	consistency	nf
nobleza	nobility, uprightness	nf
terrestre	earthly, of the earth	adj
impotencia	impotence	nf
vislumbrar	to glimpse	v
cordial	cordial, friendly	adj
hostilidad	hostility, enmity	nf
angustiado	anguished, distressed	adj
medicamento	medicine, drug	nm
entrenar	to train	v
piadoso	pious, devout, merciful	adj
corporal	of the body, corporal	adj
conspiración	conspiracy	nf
ilimitado	unlimited	adj
detención	detention, arrest	nf
autobús	bus	nm
firmemente	firmly	adv
esporádico	sporadic	adj
destreza	skill	nf
razonar	to reason out, think	v
entrañas	insides, bowels	nf
gratitud	gratitude	nf
rectificar	to rectify, straighten out	v
melancólico	melancholy	adj
editorial	publisher (f), editorial article (m)	nmf
móvil	mobile	adj
bicho	bug, creature	nm
martillo	hammer	nm
robusto	strong, robust, sturdy	adj
cooperación	cooperation	nf
elevación	rise, elevation, increase	nf
atentado	attack, offense	nm
puñado	fistful, small group	nm
llano	flat, level, plain	adj
colombiano	Colombian	adj
sirena	siren, mermaid	nf
espuma	foam, lather	nf
cirujano	surgeon	nm/f
angustioso	distressing	adj
vereda	path, sidewalk	nf
excitar	to excite	v
