reivindicación	claim, demand, redemption	nf
infección	infection	nf
chiquillo	kid, youngster	nm
distracción	distraction, amusement	nf
enumerar	to enumerate, count	v
estadístico	statistical	adj
ingrediente	ingredient	nm
posar	to rest, pose, land	v
maligno	evil, malignant	adj
irritar	to irritate	v
pugna	battle, struggle	nf
comprensivo	understanding (adj)	adj
hueco	hollow (adj)	nm
torta	cake	nf
intérprete	performer, interpreter	nc
araña	spider	nf
facción	face feature, faction	nf
elocuente	eloquent	adj
tumbar	to knock over, cast down	v
adentrar	to penetrate, go inside	v
diplomático	diplomat (nm/f)	nm/f
exhibición	exhibition, showing	nf
relajar	to relax	v
escaparate	showcase, display window	nm
afín	related, similar	adj
sargento	sergeant	nm
recrear	to recreate, amuse	v
usual	normal, usual	adj
estética	aesthetics	nf
caballería	cavalry, knighthood	nf
padrino	godparent, sponsor	nm
diversidad	diversity, variety	nf
banquete	banquet, feast	nm
bancario	bank, banking	adj
impartir	to impart, administer	v
andar	walk, gait, pace (nm)	v
gigante	giant (nc)	nc
afortunado	fortunate	adj
pabellón	pavilion, sports hall	nm
abeja	bee	nf
asentir	to assent, agree	v
espontáneamente	spontaneously	adv
informativo	informative	adj
violín	violin	nm
astro	star (nm)	nm
dictador	dictator	nm
roce	brush, rubbing, contact	nm
prolongación	extension	nf
cráneo	skull, cranium	nm
aflojar	to loosen	v
hola	hello, hi	interj
importado	imported	adj
íntegro	whole, entire, honest	adj
agradecimiento	gratitude, gratefulness	nm
extra	extra	adj
audacia	boldness, audacity	nf
cólera	rage (f), cholera (m)	nmf
resignación	resignation, acceptance	nf
legislación	legislation	nf
recíproco	reciprocal	adj
caramelo	piece of candy, caramel	nm
pólvora	gunpowder, powder	nf
rol	role	nm
fértil	fertile, rich	adj
ensuciar	to get dirty	v
largar	to let go, start out	v
acomodado	well-to-do, suitable	adj
idiota	idiot, dunce	nc
bahía	bay	nf
latitud	latitude	nf
buey	ox	nm
vaivén	swinging, rocking	nm
equivocación	mistake, misconception	nf
comunismo	communism	nm
partícula	particle	nf
intermedio	means, interval (nm)	nm
económicamente	economically	adv
limosna	alms, charity	nf
equivalente	equivalent (nm)	nm
flecha	arrow, dart	nf
soberano	sovereign, self-assured	adj
presentir	to sense in advance	v
desilusión	disappointment, letdown	nf
insertar	to insert, put in	v
pato	duck	nm
guerrero	warrior, warlike (adj)	adj
grieta	crack, opening, slit	nf
jinete	rider, horseman	nm
involuntario	involuntary	adj
discurrir	to flow, pass, roam	v
inexistente	non-existent	adj
subjetivo	subjective	adj
agricultor	farmer	nm/f
garra	claw, fang	nf
engordar	to fatten, get fat	v
soporte	support, endorsement	nm
concurrencia	coming together, participation	nf
pirámide	pyramid	nf
aventurar	to venture, risk	v
neutro	neutral	adj
