demandar	to claim, sue	v
fósforo	match, match stick	nm
profeta	prophet	nm
renacer	to be reborn, reappear	v
restablecer	to reestablish, restore	v
muslo	thigh	nm
desconcertado	disoriented, disconcerted	adj
retiro	withdrawal, retreat	nm
comando	command, order	nm
sobrevenir	to happen unexpectedly, befall, ensue	v
emisión	broadcast, emission	nf
rebasar	to exceed, pass over	v
tenor	meaning, sense, tenor	nm
recompensa	reward, recompense	nf
complicidad	involvement, complicity	nf
recelo	mistrust, suspicion	nm
vibración	vibration	nf
restricción	restriction	nf
acatar	to comply with, abide by	v
transitar	to roam, go by	v
vara	rod, stick	nf
clientela	customers, clients	nf
soberanía	sovereignty	nf
impreciso	imprecise	adj
percatar	to inform, become aware	v
frialdad	coldness, indifference	nf
encomendar	to commend, entrust	v
inspección	inspection	nf
inicial	initial (letters) (nf)	nf
seducir	to seduce, tempt	v
incidencia	incidence, impact	nf
retroceso	movement backwards	nm
micrófono	microphone	nm
previsible	foreseeable	adj
ventanilla	vehicle window, box office	nf
frontal	frontal	adj
extinción	extinction	nf
infinito	infinite, infinity (nm)	nm
campeón	champion	nm
incidir	to influence, affect	v
monstruoso	monstrous	adj
persistente	persistent	adj
oxígeno	oxygen	nm
rigidez	rigidity	nf
educado	educated	adj
irreversible	irreversible	adj
despedida	goodbye, farewell	nf
vengar	to take revenge, avenge	v
encaje	lace	nm
estropear	to ruin, mess up	v
repercusión	repercussion, impact	nf
prematuro	premature	adj
fascinar	to fascinate	v
ganador	winner	nm
emperador	emperor	nm
cometa	comet (m), kite (f)	nmf
precedente	precedent	nm
rudo	rude, crude, coarse	adj
cerebral	cerebral	adj
mosaico	mosaic	nm
significación	meaning, significance	nf
contestación	answer	nf
pedagógico	pedagogical, teaching	adj
asilo	asylum, shelter	nm
incremento	increase, raise	nm
incurrir	to incur, fall into	v
lomo	back, loin, spine	nm
tentar	to tempt, entice	v
navegación	navigation, shipping	nf
edificación	construction, building	nf
abstracción	abstraction	nf
veintidós	twenty-two	num
grotesco	grotesque, ridiculous	adj
duramente	harshly, severely	adv
sumido	sunken, drowned	adj
públicamente	publicly, in public	adv
resignar	to resign, relinquish	v
mortal	mortal (nc)	nc
siniestro	sinister	adj
místico	mystical	adj
cabina	cabin, cockpit	nf
dialogar	to confer, talk	v
exento	exempt, free	adj
guerrero	warrior, soldier (nm/f)	nm/f
acera	sidewalk	nf
clínico	clinical	adj
largamente	for a long time, at length	adv
callejero	of the street	adj
adherir	to adhere, attach	v
voluntariamente	voluntarily	adv
centavo	cent	nm
molino	mill, windmill	nm
parcialmente	partially	adv
decepción	disappointment, disenchantment	nf
alojar	to host, accommodate	v
debidamente	properly, duly	adv
ente	entity, being, firm	nm
internar	to confine	v
mismísimo	very same	adj
contundente	decisive, blunt, forceful	adj
